{
	"game":{
        "revive_player_pos":false,
        "revive_times":4,
        "vision":3,
        "power_create_num":10,
		"timeout":600
	},
	"map":
	{
		"height":20,
		"width":20,
		"map_str":"
        ...A................
        .#................#.
        .<.2...######...2.>.
        v..2............2..v
        ........#...#.......
        ......<<55155>>.....
        ........#...#.......
        ....<<<.......^^^.O.
        ...v.a.....2.>..O<..
        ..v5...X2.2.<..5..>O
        ..v..<^.X...<..5..>.
        ..v.5.^X2.2..<...>..
        ..v>>>>O......vvv...
        ...O..............B.
        ...O..X.#...#...2...
        ......<<.....>>.2...
        ^..OO...#...#...2..^
        .<.####.......###.>.
        .#................#.
        ................b...
			"
	}
}