{
	"game":{
        "revive_player_pos":false,
        "revive_times":4,
        "vision":3,
        "power_create_num":10,
		"timeout":600
	},
	"map":
	{
		"height":20,
		"width":20,
		"map_str":"
			.X.A................
			.#................#.
			.<.2...######...2.>.
			v..2......O.....2..v
			........#...#.......
			......<<55155>>.....
			........#...#.......
			.........O.........X
			..<<<a...^....v...^.
			.v5.....^.^...v#..^.
			..###..#####..v5#5^.
			....5v.v2.2v..v..#^.
			..<<<..v...v..v...^.
			X........O........B.
			...2....#...#...2...
			...2..<<55155>>.2...
			^..2....#...#...2..^
			.<.####.......###.>.
			.#................#.
			.........O......b.X.
			"
	}
}