{
	"game":{
        "revive_player_pos":false,
        "revive_times":4,
        "vision":3,
        "power_create_num":10,
		"timeout":600
	},
	"map":
	{
		"height":20,
		"width":20,
		"map_str":"
		....................
		....................
		....................
		....................
		....................
		...X...........O....
		....................
		....................
		.....O.....X........
		....................
		....................
		....................
		....................
		.....X......O.......
		....................
		..O............X....
		....................
		....................
		....................
		....................
			"
	}
}