{
	"game":{
        "revive_player_pos":false,
        "revive_times":4,
        "vision":3,
        "power_create_num":10,
		"timeout":800
	},
	"map":
	{
		"height":20,
		"width":20,
		"map_str":"
.O...#...#.O.#...#..
...#...#...#...#A#.X
##################..
.D#..............##.
.##..............#..
..#..B........C..#.#
#.#...#111111#...#..
..#....##..##....##.
X##...#555555#...#..
..#....#.v^.#....#.#
#.#....#.v^.#....#..
..#...#555555#...##X
.##....#....#....#..
..#...#111111#...#.#
#.#..a........d..#..
..#..............##.
.##..............#b.
..##################
X.#c#...#...#...#...
..#...#.O.#...#...O.
		"
	}
}