{
	"game":{
        "revive_player_pos":false,
        "revive_times":4,
        "vision":3,
        "power_create_num":10,
		"timeout":800
	},
	"map":
	{
		"height":20,
		"width":20,
		"map_str":"
		.O.A................
.#................#.
.<.2...######...2.>.
v..2......X.....2..v
........#...#.......
......<<55155>>.....
........#...#.......
.........X.........O
..<<<a...^....v...^.
.v5.....^.^...v#..^.
..###..#####..v5#5^.
....5v.v2.2v..v..#^.
..<<<..v...v..v...^.
O........X........B.
...2....#...#...2...
...2..<<55155>>.2...
^..2....#...#...2..^
.<.####.......###.>.
.#................#.
.........X......b.O.
		"
	}
}